																								
PALABRA	PALABRA	ORACION EN CUICATECO	ORACIÓN EN ESPAÑOL																					
Gea	Subida	Yeabean gea yùni 	El camino está muy de subida																					
Jabnutu / jaunutu	Vuelta	Tadï kon jabnututa 	Esa niña da vueltas																					
Gèche	Macizo	A kue'e gèche nete	Ya va matizando el ejote																					
Géche 	Ala	Cheatu géche tu'u ñe'e	Quebré el ala de mi pollo																					
Gëe	Huele	Kàba gëe diibi iti	Huele mal el estiércol de animal																					
Gèète	Tripa	Bea gèète kuchi	El cerdo tiene tripas																					
Jiba	Petate	Jaa jiba ñe’e chaku	Está nuevo el petate de mi mamá 																					
Jíba 	Arrollo o Sanja	Nanad jíba ñe’e nunkubi	Haz una sanga para el agua de lluvia																					
Gibii	hierbabuena 	Ya'a ndá gëe gibii	Huele muy bien la hierbabuena 																					
Gideabe	Está amaneciendo	Un jinanuchi toch gideabe	Yo me despierto cuando amanece																					
Jidéaku	Basura	Nankued jidéaku chi chinod toó	Levanta la basura que tiraste allí 																					
Jidijü	Estoy escribiendo 	Jidijü chi jobe	Estoy escribiendo mi nombre																					
Gi'ï	Gotea	Gi'ï tï ba'a ñe'ë	Gotea el techo de mi casa																					
Jíku	Cerro	Yeabean bea sangáta no jíku	Hay muchos lobos en el cerro																					
Jika	Camina	Yeabean kani jika sakó	Él camina muy rápido 																					
Jíku	Río 	Ú che'ë no jíku	Yo fui al río 																					
Gikuu	Cuchillo	Nuku gikuu ínu itintu	Con cuchillo mato al toro																					
Gimbeaku	Hierba Santa	Kunu ama toó gimbeaku chete tiba	Le voy a poner una hoja de hierba santa a la empanada																					
Ginchéte	Lodo	Tochi jino nùni yeaben ji ginchéte	Cuando tiro agua, se hace mucho lodo																					
Ginoyaanti	Bostezar	Toch ne'ë kuyadu yeaben ginoyaanti	Cuando quiero dormir me dan ganas de bostezar																					
Jita	Canta	Ya'a yeabe jita yadkuöo	Canta muy bonito el canario (pájaro)																					
Gíta 	Dolor	Yeaben gíta ko'o 	Me duele mucho el pie																					
Jitiaka	Platanal	Jitiaka ñe'ën yeaben ndaá jiné tiaka ñe'e	Mi platanal da muchos platanos																					
Gíyeye	Ceniza	Dimoo gíyeye jinoo ñe’e jíyuu	Pura ceniza sale del carrizo																					
Giyeyoo	Bule (para agua)	No ama giyeyoo íi nuni ñe'ë 	En un bule echo mi agua																					
Giyuu	Carbón 	Chidan jinatnoy giyuu ñe'ëñ	Mi papá está sacando su carbón 																					
Gua	No	Gua ne'ë ko'o nukud	No quiero ir contigo																					
Íkùù	Hormiga 	¿A ko'ó ama íkùù dii?	¿Te picó una hormiga?																					
Íku	Ayer	Íku che'é kuete	Ayer fui al campo																					
Itño'ö	Luciérnaga 	Tochi a jimaa jino itño'ö	Cuando anochece sale la luciernaga																					
Itño'o	Insecto palo	Chivatun je'et itño'o	El chivo se come al insecto palo																					
Iyu	Mes	Iyu jòò dí ama biku no baku	En el mes de junio voy a hacer una fiesta en mi casa																					
Itjoó	Cadera 	Chèènu itjoó takoó	Está ancha la cadera de esa mujer																					
Íba	Hilo	luti íba	Está corto el hilo																					
Inuu	Caliente	Yeaben inuu damid	Está muy caliente tu espalda																					
Íñu	Estrella	Too íñu nojobe	Está muy estrellado el cielo																					
Iba	Hielo	Yeaben icha iba	Está muy frío el hielo 																					
Itduza	Puerco espín	Yeaben nicha obe itduza chi chinu	Estaban muy grandes dos puerco espines que maté																					
Ínuu	Calor	Yeabean ínuu jibaku	Hace mucho calor en Cuicatlán.																					
Iti	Animal	Bea iti kuete.	Hay animales en el campo.																					
Itjingatu	Libélula	Yeabean bea itjingatu noo nùni	Hay mucha libélula en el agua.																					
Itsó	Sapo	Yeabean bee itsó	Hay muchos sapos.																					
Itcheanu	Venado	Bea itcheanu jikio'ö	Hay venados en el bosque.																					
Intie'ë	Autoridad	Intie'ë ay dí	La autoridad te llama.																					
Iyu	Luna	To nda bea deabea ñe'e iyu.	La luna da mucha luz.																					
Iña	Gente	Too ñoo iña noy biku	Llegó mucha gente en la fiesta.																					
Itkudintaa	Tijerilla(insecto)	Chínu ama itkudintaa	Maté a un insecto tijerilla.																					
Itso'ö	Guajolote	Itso'ö  ñe'en a net iñ'to'ö.	Mi guajolote quiere apariarse con una guajolota.																					
I'baa	Guacamaya	Dinu nichis ama i'baa	Mí hermano vió una guacamaya.																					
It dituu	Mula	Yeabean kaba jidií it dituu ñe'ë	Mi mula hace feo.																					
It icha	Cochinilla	Dijinun nichis ama it icha	Mí nieto vió una cochinilla.																					
Itintu	Toro	Bea itintu ñë'e chida	Mi papa tiene toros.																					
Íyu	Pulga	Yeabean snuú íyu yana ñe'ë	Mi perro tiene muchas pulgas.																					
Into'ö	Suegra	Into'ö jobey María	Mi suegra se llama María.																					
Iñso'ö niku	Suegro	Iñso'ö niku jobey Luis.	Mi suegro se llama Luis.																					
Íma	Zorrillo	Diyan chinuy ama íma	Mi tío mató un zorrillo.																					
ii	Pesa	Gua ii chedee ñe'e iti ñe'ë	No pesa la carga de mi animal.																					
Iyaa	Chile	Ne'ë che'e ama iyaa	Quiero comer un chile.																					
Inbíku	Semana santa	Ná kuchi ninu inbíku	Se acerca la semana santa.																					
In'ö	Sueño(soñar)	Yaá kaba in'ö	Sueño muy feo.																					
Í'ku	Piojo	Snú í'ku tï	Tengo piojo en la cabeza.																					
I'yaa	Aguila	Ama i'yaa kanat ama kuu	Un águila se llevó a una víbora.																					
It dutu	Caracol	Ama it dutu kanet no ama ño'o	Un caracol esta en un palo.																					
Iynutii	Chile piquín	Káku naiyaá ñeé iynutii	Voy a hacer salsa de chile piquín.																					
Iñto'ö	Guajolota	A bea kuni ñee iñto'ö ñe'ë	Ya tiene guajolotitos mi guajolota.																					
I'yu	Mecate	Ú ká ama tö i'yu	Yo compré un pedazo de mecate.																					
Itda'aa	Alacrán	Un bo'o itda'aa	Yo le tengo miedo al alacrán.																					
Ícha	Tipo de quelite	Ú ne'ë che'e yata ícha	Yo quiero comer quelite.																					
icha	frío	Un tö icha	Yo tengo mucho frío.																					
Ja'a	Cáscara	Yeaben chéche ja'a ñee yuku	Está muy dura la cáscara de la calabaza.																					
Jààba	Ingredientes	Ne'ë jààba ñe'e kántu chi nana	Quiero ingredientes para el caldo que voy a hacer.																					
Jába	Ladra	Jába yana ñe'ë	Ladra mi perro.																					
Jadi	Tepache	Nochi inbakuyan jiíy jadi	Donde se casan toman tepache																					
Jeakuy	Llorar	Ta María jeakuta	María está llorando.																					
Jeakuy	tapar	Chakun jeakuy pañu ñe'eñ	Mi mamá se tapa su rebozo																					
Jeanu	Correr	Juchin yeaben jeanuta	Mi sobrina corre mucho.																					
Jiba	Petate	Chiku'ún kay ama jiba.	Mí abuelita compró un petate.																					
Jeakuy	tapar 	chaku jeakuy pañu ñe'eñ	Mi mamá se tapa su rebozo																					
Jijobaa	sombras de estaciones en la fiesta de semana santa	Toch inbíku jinay jijobaa	En la fiesta de semana santa hacen sombras.																					
Jikio'ö	Bosque	Jikio'ö china jíkuu ñe'ë	En el bosque perdí mi machete.																					
Jima	Sal	Kunud jima nochi jinee no yuntu	Ponle sal a la comida.																					
Jinákuu	Reglamento, bastón de mando	Santië jinay jinákuu	El presidente lleva el bastón de mando.																					
Jingö	Milpa	Yeabean cheate jingö ñe'ë	Esta muy grande mi milpa.																					
Jingunoo	Masticar	Jingunoo yúduu ñe'ë yama ñë'ét	Mi animal mastica su zacate.																					
Jingu	Moler	Jingu bèèye ñe'ë	Esta moliendo mi nixtamal.																					
Jindiyaa	Asusta	¿A jindiyaa kuu dií?	¿Te asusta una víbora?.																					
Jiniku	Vender	Un jiniku nutbii	Yo vendo frutas.																					
Jinìnii	Araña	Nichi ama jinìnii.	Ví una araña																					
Jinta	Se moja	Toch jinoo, jinta tikaa	Cuando lavo, se moja mi ropa.																					
Jíntinii	Estaca para sembrar	Chidan jitubiy jínyinii	Mi papá ocupa estaca para sembrar.																					
Jintu	Barbecho	A jintu noo ño'ö ñe'ë	Ya estan barbechando mi terreno.																					
Jiyáka	Polvo	Tochi jeanu yuna yeabean jinkue jiyáka	Cuando hay viento levanta mucho polvo.																					
Jiyuu	Carrizo	Chida kuey guay jiyuu	Mi papa se fue a traer carrizo.																					
Jobe	Día	Un ko'o jobe inu kuete	Yo voy a ir el día miércoles al campo.																					
Jóbe	Nombre	Iña kon jóbey nacho	Ese señor se llama Ignacio																					
Jòò	Seis	Diya bea jòò chivato ñe'ëñ	Mi tío tiene seis chivos.																					
Jo'ö	Suena	Yeabean jo'ö jíku ñee jibaku	Suena mucho el río de Cuicatlán.																					
Joobe	Voladero	Ama iti chinót no joobe	Un animal cayó a un voladero.																					
Juchi	Sobrina	Juchi bea so'ö jinenúkuta	Mi sobrina tiene novio.																					
Júku	Estaca	Kakad ama júku ñe'e iti ñe'ë	Corta una estaca para mi animal.																					
Ju'ü	Cinco	Julio bea ju'u itintu ñe'ës	Julio tiene cinco toros.																					
Jubii	Lugar arenoso	Yeabean jubii bèè jikuu ñeé mu'u	Esta muy arenoso la orilla del río de aquí																					
jubii	_	nan jubid beaye	_																					
Juuchi	flama	chitoó juuchi to'o.	Me quemé con la flama.																					
Kä	Sancudo	Noo baku bea kä	Hay zancudos en mi casa																					
Káa	Filo	Tanod káa ñe acha ñe'ë	Sacale filo a mi acha.																					
Kaaba	Suelto	Yeabean kaaba snú niibii	Esta muy suelta la papa (papa en la tierra).																					
Kàba	Feo	Kàba jí nochi jaá	Se pone feo donde se derrumba.																					
Kàchi	Avispa	Ko'ó ama kàchi uu	Me picó una avispa.																					
káchi	hervir	a jinda chi  káchi nùnim	falta mucho para que hierva el agua.																					
Kachí	vomitar	ne'e kachí tochi jinkuë chete	Quiero vomitar cuando se me revuelve el estomago 																					
Kadi	Peso($)	Ted ama kadi uu	Dame un peso.																					
Kadínu	Almorzar	A mnòò kadínu	Ya tiene rato que alimorcé.																					
Kadinu	Me enterare	A kadinu a déa bea	Ya me enterare de lo que esta pasando.																					
Kajobe	Antier, anteayer	Kajobe naka ama kadi	Antier encontré un peso.																					
Kaka	Papel	Ted ama toó kaka ú	Dame un pedazo de papel.																					
Káka	Peine	Ted káka ñe'ë	Dame mi peine.																					
Kaka yòò	Cal	Toch jinuu bèèya íi kaka ño'ö.	Cuando pongo nixtamal le hecho cal.																					
Kákaa	Cansancio	Kákaa ndimi chi kaneé no'o	Esta cansado mi hombro por cargar leña.																					
Kàkad	Cortar	¿A kod kàkad no'o?	¿Irás a cortar leña?																					
Kakio'öd	Quemar	Kued kakio'öd jideku ko	Ve a quemar esa basura.																					
Kamad	Leer, Habla.	Kued kamad	Ve a leer																					
Kambo	Compadre	Kambo ñe'ë jiíy jadii	Mi compadre toma tepache.																					
Kanbaku	Casar	¿A dea jobe kanbakud?	¿Cuando te vas a casar?																					
		Uu kanbaku iyu chi kuchi	Yo me caso el próximo mes.																					
Kane	Está	¿A kane dinu mu'u?	¿Esta mi hermano aquí?																					
Kaniku	Deber(algo pendiente)	Kaniku tumi tòò	Debo dinero ahí.																					
Kaníku	Algo colgado	Kaníku tikaa no ño'o	Mi ropa está colgado en el árbol.																					
Känta	Delicado, peligroso	Dikayan yeabean käntay	Los niños son muy delicados.																					
Kantaa	Guerra	A kutea ko'od kantaa	Ya no iras a la guerra.																					
Kanú	Cargar	Ne kanú dií.	Te quiero cargar.																					
Kánud	Corre	Kánud ñuu kat ne'é chi dii nanomnod	Corre, apurate, quiero que tu llegues primero.																					
Kanuñ	Está (adentro)	Gua kanuñ ba'a	No esta en la casa.																					
Karrunti	Arcoiris	Tochi a inu jee, jinó karrunti	Cuando termina de llover, sale el arcoíris.																					
Kata	Cantar	¿A tii ko'öd katad?	¿Dónde iras a cantar?																					
		Kata ñe'e chi kanuchii.	Le canto a la vida.																					
Káya	pequeñas.	Yeabean káya najaá	Estan muy pequeñas las nueces.																					
Keabea	Hermano a hermano	Chidan bea obe keabeay.	Mi papá tiene dos hermanos.																					
Keadea	Comezón	Keadea dami	Tengo comezón en la espalda.																					
Kiana	Camisa	Kuo'o kiana ñe'e sakó	Es roja la camisa de aquel.																					
Kinü	Mañana en la noche	kinü nubdamau'u nuku bi'i 	Mañana en la noche nos reuniremos																					
Ko'ö	Voy	Ko'ö dï ntiñu	Voy ir a trabajar.																					
Ko'o	Pie	Yeaben eate ko'o	Esta muy grande mi pie.																					
Ko'öd	Iras o vé	Ko'öd jibaku	Iras a Cuicatlán.																					
Kú'u	tomar	Kú'u ama nunyadi	Voy a tomar un refresco.																					
Ku'u	Plato	Ted ku'u kui che'ed	Dame un plato para servirte de comer.																					
Kuaa	Relámpago	Tochi jee kubno'o bea kuaa	Cuando hay aguacero hay relámpago.																					
Kuàà	Derrumbe	Mii ne'é kuàà	Ahí se quiere derrumbar.																					
Kuä	Negro	U bea obe it dituu kuä ñe'ë	Yo tengo dos mulas negras.																					
Kuaku	Derecho	Ne'é ama ño'o kuaku 	Quiero un palo derecho.																					
	Verdad(cierto)	Gua kuaku chi jo'ód	No es verdad lo que dices.																					
Kubdeabea	Amanecer	A ne'e kubdeabea	Ya está amaneciendo.																					
Kubi	Lluvia	Tochi jee kubi jinbinti yata.	Cuando llueve retoñan las hierbas.																					
Kubno'ö	Aguacero	Tochi jììya kuaa, jee kubno'ö	Cuando hay relampago es porque hay aguacero.																					
Kuch-cheanu	Jabalí	Chidan nichiy ama kuch-cheanu	Mi papá vio un jabalí																					
Kuchi	Marrano	Ú bea ama kuchi ñe'ë	Yo tengo un marrano.																					
Kuch-nùni	Tepexcuintle	Chidan nichiy ama kuch-nùni	Mi papá vio un tepexcuintle.																					
Kudiana	Campamocha	Ti bi'in nichita ama kudiana	Mi hermana vió una campamocha.																					
Kudima	Calzón de manta.	So'ön jinus kudima	Los hombres usan calzón de manta.																					
Kudintaa	Tijera	Ted kudintaa kat ne'e kaaka kaka kú.	Dame la tijera que quiero cortar este papel.																					
Kudubi	Cuchara	Ted ama kudubi ú	Dame una cuchara.																					
Kuea	Blanco	Un kané ama yúduu kuea ñe'ë	Yo tengo un caballo blanco																					
Kueatea	Canasto	Che'e tumaa ama kueatea neatu	Fui a cortar un canasto de tomates.																					
Kueat'ichi	Canasta	Nòò kueat'ichi ii pö chi jiniku	En una canasta echo el pan que vendo.																					
Kuëd	Aprender	Kuëd did ntiñu.	Aprende a trabajar.																					
Kuèè	Verde	Yaá kuèè yata chi bea kuete	Esta muy verde la hierba que hay en el campo.																					
Kué	Chueco	Yeaben kué ko'od	Esta muy chueco tu pie.																					
Kuëe	Va a llover	Ne'e kuëe	Quiere llover.																					
Kúë	Delgado	Yeabean kúë takoo	Ella es muy delgada.																					
Kuejobe	Azul cielo	Yeabean kuejobe kiana ñë'ed	Esta muy azul tu camisa.																					
Kuejuku	Adornar	Ne'é chi kuejuku chinti yáku	Necesita adornarse la puerta de la iglesia.																					
Kuete	Campo	Dinuu ku'es kuete	Mi hermano se fue al campo.																					
Kuili	Renacuajo	Yeaben bea kuili nóó nun lï koó	Hay muchos renacuajos en ese arroyo.																					
Kuintu	Mojado	Noo kiana ñë'ed man kuintu.	Lavé tu camisa ahora esta mojado.																					
Kuiñu	Comadreja	Yeabean bea kuïñu kuete ñe'ë	Hay muchas comadrejas en mi campo.																					
kuiñú	picudo	Yeaben kiuñú tï jiku	Esta muy picudo la punta de ese cerro.																					
																								
																								
																								
																								
																								
																								
																								
																								
																								
																								
																								
																								
																								
																								
																								
																								
																								
																								
																								
																								
																								
																								
																								
																								
																								
																								
																								
																								
																								
																								
																								
																								
																								
																								
																								
																								
																								
																								
																								
																								
																								
																								
																								
																								
																								
																								
																								
																								
																								
																								
																								
																								
																								
																								
																								
																								
																								
																								
																								
																								
																								
																								
																								
																								
																								
																								
																								
																								
																								
																								
																								
																								
																								
																								
																								
																								
																								
																								
																								
																								
																								
																								
																								
																								
																								
																								
																								
																								
																								
																								
																								
																								
																								
																								
																								
																								
																								
																								
																								
																								
																								
																								
																								
																								
																								
																								
																								
																								
																								
																								
																								
																								
																								
																								
																								
																								
																								
																								
																								
																								
																								
																								
																								
																								
																								
																								
																								
																								
																								
																								
																								
																								
																								
																								
																								
																								
																								
																								
																								
																								
																								
																								
																								
																								
																								
																								
																								
																								
																								
																								
																								
																								
																								
																								
																								
																								
																								
																								
																								
																								
																								
																								
																								
																								
																								
																								
																								
																								
																								
																								
																								
																								
																								
																								
																								
																								
																								
																								
																								
																								
																								
																								
																								
																								
																								
																								
																								
																								
																								
																								
																								
																								
																								
																								
																								
																								
																								
																								
																								
																								
																								
																								
																								
																								
																								
																								
																								
																								
																								
																								
																								
																								
																								
																								
																								
																								
																								
																								
																								
																								
																								
																								
																								
																								
																								
																								
																								
																								
																								
																								
																								
																								
																								
																								
																								
																								
																								
																								
																								
																								
																								
																								
																								
																								
																								
																								
																								
																								
																								
																								
																								
																								
																								
																								
																								
																								
																								
																								
																								
																								
																								
																								
																								
																								
																								
																								
																								
																								
																								
																								
																								
																								
																								
																								
																								
																								
																								
																								
																								
																								
																								
																								
																								
																								
																								
																								
																								
																								
																								
																								
																								
																								
																								
																								
																								
																								
																								
																								
																								
																								
																								
																								
																								
																								
																								
																								
																								
																								
																								
																								
																								
																								
																								
																								
																								
																								
																								
																								
																								
																								
																								
																								
																								
																								
																								
																								
																								
																								
																								
																								
																								
																								
																								
																								
																								
																								
																								
																								
																								
																								
																								
																								
																								
																								
																								
																								
																								
																								
																								
																								
																								
																								
																								
																								
																								
																								
																								
																								
																								
																								
																								
																								
																								
																								
																								
																								
																								
																								
																								
																								
																								
																								
																								
																								
																								
																								
																								
																								
																								
																								
																								
																								
																								
																								
																								
																								
																								
																								
																								
																								
																								
																								
																								
																								
																								
																								
																								
																								
																								
																								
																								
																								
																								
																								
																								
																								
																								
																								
																								
																								
																								
																								
																								
																								
																								
																								
																								
																								
																								
																								
																								
																								
																								
																								
																								
																								
																								
																								
																								
																								
																								
																								
																								
																								
																								
																								
																								
																								
																								
																								
																								
																								
																								
																								
																								
																								
																								
																								
																								
																								
																								
																								
																								
																								
																								
																								
																								
																								
																								
																								
																								
																								
																								
																								
																								
																								
																								
																								
																								
																								
																								
																								
																								
																								
																								
																								
																								
																								
																								
																								
																								
																								
																								
																								
																								
																								
																								
																								
																								
																								
																								
																								
																								
																								
																								
																								
																								
																								
																								
																								
																								
																								
																								
																								
																								
																								
																								
																								
																								
																								
																								
																								
																								
																								
																								
																								
																								
																								
																								
																								
																								
																								
																								
																								
																								
																								
																								
																								
																								
																								
																								
																								
																								
																								
																								
																								
																								
																								
																								
																								
																								
																								
																								
																								
																								
																								
																								
																								
																								
																								
																								
																								
																								
																								
																								
																								
																								
																								
																								
																								
																								
																								
																								
																								
																								
																								
																								
																								
																								
																								
																								
																								
																								
																								
																								
																								
																								
																								
																								
																								
																								
																								
																								
																								
																								
																								
																								
																								
																								
																								
																								
																								
																								
																								
																								
																								
																								
																								
																								
																								
																								
																								
																								
																								
																								
																								
																								
																								
																								
																								
																								
																								
																								
																								
																								
																								
																								
																								
																								
																								
																								
																								
																								
																								
																								
																								
																								
																								
																								
																								
																								
																								
																								
																								
																								
																								
																								
																								
																								
																								
																								
																								
																								
																								
																								
																								
																								
																								
																								
																								
																								
																								
																								
																								
																								
																								
																								
																								
																								
																								
																								
																								
																								
																								
																								
																								
																								
																								
																								
																								
																								
																								
																								
																								
																								
																								
																								
																								
																								
																								
																								
																								
																								
																								
																								
																								
																								
																								
																								
																								
																								
																								
																								
																								
																								
																								
																								
																								
																								
																								
																								
																								
																								
																								
																								
																								
																								
																								
																								
																								
																								
																								
																								
																								
																								
																								
																								
																								
																								
																								
																								
																								
																								
																								
																								
																								
																								
																								
																								
																								
																								
																								
																								
																								
																								
																								
																								
																								
																								
																								
																								
																								
																								
																								
																								
																								
																								
																								
																								
																								
																								
																								
																								
																								
																								
																								
																								
																								
																								
																								
																								
																								
																								
																								
																								
																								
																								
																								
																								
																								
																								
																								
																								
																								
																								
																								
																								
																								
																								
																								
																								
																								
																								
																								
																								
																								
																								
																								
																								
																								
																								
																								
																								
																								
																								
																								
																								
																								
																								
																								
																								
																								
																								
																								
																								
																								
																								
																								
																								
																								
																								
																								
																								
																								
																								
																								
																								
																								
																								
																								
																								
																								
																								
																								
																								
																								
																								
																								
